3131311111311113111110111131132
3022112312211320331112231210222
2123302022130011023303023131222
3020211112203111120230300202222
2112311121110311223030312132022
2302211111113121202301221203302
3022231231302212112312212302222
2112102202120302322122302232022
2121312111213120202222030220122
3122121112222212310302303031122
2203011222220321211030211203022
2111310102112032113121312111202
2310231131103002320223021122322
2233023203110310211030311212202
2220120111312213031123021102232
2231113110221222110221121110222
2223102311232222313021211313022
2202110222020103021213112222102
2131111221301312330320322021112
3223031012311020023013021112302
2212121312031111302322113122222
2102210221103112212202120221212
2130312231110320222211123030302
3212221023131011102131022123012
2122233120231123112223103221102
2221220231023222322221120213122
2312023021102022023031011020220
2221112131112123022311123113022
2031221021211020122013030121122
2302212312311113221302103113022
2030322220211122030211112122122
3123023031031023102313113022202
2302120311223102111020122321122
2231031102121122311231220011212
2021212311231021032302211311102
2122120231023311102032111231122
3031213023102012311101112023022
2302302203031110231111211121102
2232230310122311221112121223112
2020021111022012011103012101022
1111111111111111111111111111110
