3111111111131111131111311111112
2311112311222111303211223111312
2031121032103132030112022132022
2311213121110203123101121201122
2102022203123101222131221111222
3111121212221112203021012131022
2121212320211122212111113023122
2310310231031122311131102101022
3031031021123202031203123311122
2223113023102113121112222231202
2220302122112302223120200222322
2311230201302210221231112202222
2222211231030313130223101130222
2021112103122220201221131023002
2312311310203031130031021303122
2102021012110303211121130102212
3111123111111230111211231302122
2331022313132221111110222231222
2203112220220212311111022302022
2121020231023022112311302231122
2213111021303103122030232023222
2302111330212112302302221302022
2211310023103102212230222212102
2312233121210310303031230122312
2030222210231211030102021121022
3103022111102112323113111211302
2122303113111302201020310212222
3222120221122232311113123112222
0211031031010220031320220302212
2131303301312213102031213030122
2102022033021302230302122310302
2131302120312030221232102223022
3202211311031103032223112122112
2231110221101312302220223021322
2021131031131220210231021222222
2113021303022031121203112202022
2312310222323021211310112311222
3020211102222112312211122232222
2111131130221130212111220222122
2111201201011201101121011021002
1111111111111110111111111111110
