3113311111131111131133111111312
2120233031203111210222312230102
2223002122310111311020222211122
3030311212031112031111222311212
2103032222301123111232022232122
2312302302213021302021122221222
3020220232302312031301122221202
2130312022212211122211203030122
3031023102230221102112330321102
2103122230223031311212202201112
2131022101102102121122232113122
3010221131303131212222203121202
3131031022232202302120301030232
2211223102002312121031130303202
2112121113112223031003023030122
2303221122120222111310112302302
2230223103211211112313120231032
3021210320312103122020231203102
2312111010101122211111021013100
2021121113113022113111103120322
2311223110321223122312310231202
2030230313012102302223011222122
3123223021101310231222311023212
2100221031112110222220231022122
2131031122311112222031221122302
3021230210232110221122211222212
2312203103021111213022312100302
3022132310303112210102103113022
2121020231212301311311122322112
2231031022022112032121222222122
2213123303121303103030202201102
2320202232202230302112132113122
2211112022123022123123001121202
2313122101230323021021131212212
2022221031021222111113021302302
3122211221310221311120322030232
2302132310230212111213001123022
2213022031031121310220311121222
2120301021303212231111213212222
2111011112010120203110102100202
1111111111111111111111011111110
