331111311111113111111012
221211031131102122311302
212311103023111022232212
220311223121312302222302
231012030231022223002232
213121223203022222310202
320222220112303030231302
213022123130230303030212
210312202203022212123102
231022312311210303220312
210322030212111010212102
311023022303311311121110
211223121010232231211102
330202211111222030311102
201110311110021101011112
111111111111111111111110
