31113131311111311311111112
21322210213112032302311112
10200311103121302223031102
23111031110202220222323112
22111313122330231022220302
23112020222201221122211222
20301131212112212210232212
31031302122122121211020122
21302031023021112111112302
30213123103121303311122212
21302121102211020222303102
22230231112131103022212112
22212203022221312321302122
02302130302212220212231122
22211221212123031022203202
22112232121102131030310122
23230221212311223223032222
20223021121212022020102302
23022112230123103111310212
22123121223222222302211302
21221212222021210231110212
31231020221232111021312322
22021311012203103112122022
22310223102230330302221222
21031102112223023121022222
21321303122103020231110222
30202112221110311211211022
21213120211131032310231302
32130223111201302211212212
21203221122312022130322302
22310213203022310221200212
22212122122321213232130122
21303202202212302003211222
22230311230210211320312302
22002030103011110210102012
11111111111111111111111110
