20023321123013000330320102112222
03133111210003022202223121003120
31300330110103020331002313210012
03103231301233202001231102013320
23013101330323122010330332232222
13033220312120302300201303021210
13220100101123200020120111321322
31232033211123300233132120231320
31313030332003322110300331200112
22233220110102200003022301011130
12030300110230303220112011103110
20103201320112331112001102003012
21322033033301000210231321231232
10220332030210012310221111323220
32000101032121022231320103301302
31110210230223313310130302121110
21301311010001200323012010001000
32330010230312021320122221310002
33310111300303203010213021121112
31300131121303113300323201212210
23211010020100130212012211312202
31132113332130300002103132322322
13132311031203301032010122013200
13230013102002001213221120123030
03133230210020331111130222300032
32212013300330032112300022033220
30212000111232330010122210223012
11321013021320223212012013103010
12332333322230020222021332222102
31122331210100231133303101102030
01220233001021122202012123031020
23322222211112030110131320012202
10323013011313130032133313222000
03113222210100012311110300001100
10213122101122333021333213321220
32333120300000032132023001010010
02303202132000001322333202113300
11312323312302231112230332330322
33333220303101213031002211230030
00312230331112330100020212321032
01010010010010010111011111010010
